[00000000000000000000000000000000]
[01111000000111111111100000110000]
[01001111111100000011111111111000]
[00111000000111111110001000001110]
[01100000000111111000001000011100]
[01111100000110011111011100000100]
[00001100000110000011011100001110]
[01111100000111111111000000011110]
[00101000000000000000000000011110]
[01111100000000011000101000010010]
[01111100000001010101111001010100]
[00110101000101010111111011010100]
[00010101000101111111011111111100]
[00110111111111000000111110100110]
[00000000000000000000000000000000]
