[00000000000000000000000000000000]
[01111111111110000001111111111110]
[01000100000011111111000000100010]
[01111101111000000000011110111110]
[00000101001111111111110010100000]
[01111111000000111100000011111110]
[01000100000000111100000000100010]
[01111111000000111100000011111110]
[00000101001111111111110010100000]
[01111101111000000000011110111110]
[01000100000011111111000000100010]
[01111111111110000001111111111110]
[00000000000000000000000000000000]
