[00000000000000000000000000000000]
[01111000000111111111100000110000]
[01001111111100000011111111111000]
[00111000000111111110001001001110]
[01100000000111111000001001011100]
[01111100111110011111011101000100]
[00001100000110000011011101001110]
[01111100000000011111000001011110]
[00101111011100011100000111011110]
[01111100000100011000101000010010]
[01111100110101010101111001010100]
[00110101100101010111111011010100]
[00010101000101111111011111111100]
[00110111111111000000111110100110]
[00000000000000000000000000000000]
