[00000000000000000000000000000000]
[01111111111111100111111111111110]
[01000010000000100100000001000010]
[01111110111110111101111101111110]
[01000010100010000001000101000010]
[01111111100011111111000111111110]
[00000100100000000000000100100000]
[01111111100111111111100111111110]
[01000010100100000000100101000010]
[01111110111111100111111101111110]
[00000010000000100100000001000000]
[01111111111111111111111111111110]
[00000000000000000000000000000000]
