[00000000000000000000000000000000]
[01111001100111111111100000110000]
[01001111111100000011111111111000]
[00111000000111111111000010101110]
[01100001010111111001111010111100]
[01111101011110011111001010100100]
[00001101001110000011001010101110]
[01111101011011111111001001101110]
[00101101010000111111111111011110]
[01111101000000011000000000010010]
[01111101110001010101111001010100]
[00110101000101010111111011010100]
[00010101000101111111010111111100]
[00110101111111000000111000100110]
[00000000000000000000000000000000]
